[@ @ @ @ @ @ @ @ @ @ @ @ @ @ @ @ @ @ @ @ @ @ @ @ @ @ @ @ @ @ @ @ @ @ @ @ @ @ @ @ @ @ @ @ @ @ @ @ @ @ @ @ @ @ @]
[@                                                               @                               @           @]
[@   @ @ @ @ @ @ @ @ @ @ @ @ @ @ @ @ @ @ @ @ @ @ @ @ @ @ @ @ @   @   @ @ @ @ @ @ @ @ @ @ @ @ @ @ @   @ @ @ @ @]
[@                       @                                   @                                               @]
[@ @ @ @     @ @ @ @     @   @ @ @ @ @ @ @ @ @ @ @ @ @ @ @   @ @ @ @ @ @ @ @ @ @ @ @ @ @ @ @ @ @ @ @ @ @     @]
[@           @           @                               @       @                               @           @]
[@   @ @ @ @ @ @ @ @     @ @ @ @     @ @ @ @ @ @ @ @ @ @ @ @ @ @ @   @ @ @ @ @ @ @ @ @ @ @ @     @   @ @ @ @ @]
[@               @                                                   @           @       @       @           @]
[@ @ @ @ @ @ @   @ @ @ @ @ @ @ @ @ @ @ @ @ @ @ @     @ @ @ @ @ @ @ @ @   @ @     @   @ @ @   @ @ @ @ @ @     @]
[@           @               @                       @                   @                   @               @]
[@   @ @ @ @ @ @ @ @ @ @     @   @ @ @ @ @ @ @ @ @ @ @ @ @ @ @ @ @ @ @ @ @   @ @ @ @ @ @ @ @ @   @ @ @ @ @ @ @]
[@               @           @               @                               @               @               @]
[@ @ @ @ @ @     @   @ @ @ @ @ @ @ @ @ @ @ @ @   @ @ @ @ @ @ @ @ @ @ @ @ @ @ @   @ @ @ @ @ @ @ @ @ @ @ @     @]
[@               @   @                       @                               @                               @]
[@   @ @ @ @ @ @ @   @   @ @ @ @ @ @ @ @     @ @ @ @ @ @ @ @ @ @ @ @ @ @     @ @ @ @ @ @ @ @ @ @     @ @ @ @ @]
[@                   @           @           @           @                   @                       @       @]
[@ @ @ @ @ @ @ @ @ @ @ @ @ @     @ @ @ @ @ @ @   @ @ @ @ @   @ @ @ @ @ @ @ @ @ @ @ @ @ @ @ @ @ @ @ @ @   @ @ @]
[@                               @                       @                                                   @]
[@   @ @ @ @ @ @ @ @ @ @ @ @     @   @ @ @ @ @ @ @ @ @   @ @ @ @ @ @ @ @ @ @ @ @ @ @ @ @ @ @ @ @ @ @ @ @     @]
[@                       @       @                   @                                                       @]
[@ @ @ @ @ @ @ @ @ @     @   @ @ @ @ @ @ @ @ @ @     @ @ @ @ @ @ @ @ @ @ @ @ @ @ @ @ @ @ @ @ @ @ @ @ @ @ @ @ @]
[@                       @                                                                                   @]
[@   @ @ @ @ @ @ @ @ @ @ @ @ @ @ @ @ @ @ @ @ @ @ @ @ @ @ @ @ @   @ @ @ @ @ @ @ @ @ @ @ @ @ @ @ @ @ @ @ @ @ @ @]
[@                                                           @                                               @]
[@ @ @ @ @ @ @ @ @ @ @ @ @ @ @ @ @ @ @ @ @ @ @ @ @ @ @ @ @ @ @ @ @ @ @ @ @ @ @ @ @ @ @   @ @ @ @ @ @ @ @     @]
[@   @               @                                                               @       @               @]
[@   @   @ @ @ @ @ @ @   @ @ @ @ @ @ @ @ @ @ @ @ @ @ @ @ @ @ @ @ @   @ @ @ @ @ @ @   @ @ @ @ @   @ @ @ @     @]
[@                                                           @   @               @               @           @]
[@ @ @ @ @ @ @ @ @ @ @ @ @ @ @ @ @ @ @ @ @ @ @ @ @ @ @ @     @   @ @ @ @ @ @ @   @ @ @ @ @ @ @ @ @   @ @ @ @ @]
[                                                    @       @               @                   @           @]
[@ @ @   @ @ @ @ @ @ @ @ @ @ @ @ @ @ @ @ @ @ @ @     @   @ @ @ @ @ @     @ @ @ @ @ @ @ @ @ @ @ @ @ @ @ @ @   @]
[@   @                                   @           @                                                   @   @]
[@   @ @ @ @ @ @ @ @ @ @ @ @ @ @ @ @     @   @ @ @ @ @ @ @ @ @ @ @ @ @ @ @ @ @ @ @ @     @ @ @ @ @ @ @ @ @   @]
[@                                       @                                       @       @                   @]
[@ @ @ @ @ @ @ @ @ @ @ @ @ @ @ @ @ @ @ @ @ @ @ @ @ @ @ @ @ @ @ @ @ @ @ @ @ @     @   @ @ @   @ @ @ @ @ @ @ @ @]
[@                                                       @                       @       @                   @]
[@   @ @ @ @ @ @ @ @ @ @ @ @ @ @ @ @ @ @ @ @ @ @ @ @ @ @ @   @ @ @ @     @   @ @ @ @ @ @ @ @ @ @ @ @ @ @     @]
[@                                                           @           @                                   @]
[@ @ @ @ @ @ @ @ @ @     @ @ @ @ @ @ @ @ @ @ @ @ @ @ @ @ @ @ @   @ @ @ @ @ @ @ @ @ @ @ @ @ @ @ @ @ @ @ @ @ @ @]
[@                                                       @                   @                   @           @]
[@   @ @ @ @ @ @ @ @ @ @ @ @ @ @ @ @ @ @ @ @ @ @ @ @     @   @ @ @ @ @ @ @ @ @   @ @ @ @ @ @     @   @ @ @   @]
[@                                       @               @                   @       @           @       @   @]
[@ @ @ @ @ @ @ @ @ @ @ @ @ @ @ @ @ @ @ @ @   @ @ @ @ @ @ @ @     @ @ @ @ @   @ @     @   @ @ @ @ @ @ @ @ @   @]
[@                                           @                   @       @           @   @                   @]
[@   @ @ @ @ @ @ @ @ @ @ @ @ @ @ @ @ @ @ @ @ @   @ @ @ @ @ @ @ @ @   @ @ @ @ @ @ @ @ @ @ @   @ @     @ @     @]
[@               @                       @       @                                           @       @       @]
[@ @ @ @ @ @     @   @ @ @   @ @ @ @     @ @ @ @ @   @ @ @ @ @ @ @ @ @ @ @ @ @ @ @ @ @ @ @ @ @ @ @ @ @ @ @ @ @]
[@               @       @   @                       @                       @                               @]
[@   @ @ @ @ @ @ @ @ @ @ @   @   @ @ @ @ @ @ @ @ @ @ @   @ @ @ @ @ @ @ @ @   @   @ @ @ @ @ @ @ @ @ @ @ @     @]
[@                           @                       @                   @       @                           @]
[@ @ @ @ @ @ @ @ @ @ @ @ @ @ @ @ @ @ @ @ @ @ @ @ @   @ @ @ @ @ @ @ @ @ @ @ @ @ @ @   @   @   @ @ @ @ @ @ @ @ @]
[@                       @                       @                                   @   @                   @]
[@ @ @ @ @ @ @ @ @ @     @   @ @ @ @ @ @ @ @ @ @ @ @ @ @ @ @ @ @ @ @ @ @ @ @ @ @ @ @ @ @ @ @ @ @ @ @ @ @     @]
[@                       @                   @                                                               @]
[@   @ @ @ @ @ @ @ @ @ @ @ @ @ @     @ @ @ @ @   @ @ @ @ @ @ @ @ @ @ @ @     @ @ @ @ @ @ @ @ @ @ @ @     @   @]
[@   @                                           @                           @                           @   @]
[@   @   @ @ @ @ @ @ @ @ @ @ @ @ @ @ @ @ @ @ @ @ @   @ @ @ @ @ @ @ @ @ @ @ @ @   @ @ @ @ @ @ @ @ @ @ @ @ @ @ @]
[@       @                                       @           @                   @           @               @]
[@ @ @ @ @   @ @ @ @ @ @ @ @ @ @ @   @ @ @ @ @ @ @ @ @ @ @   @ @ @ @ @ @ @ @ @ @ @   @ @ @ @ @   @ @ @ @     @]
[@           @       @           @       @               @                                       @           @]
[@   @ @ @ @ @ @     @   @ @ @ @ @ @     @   @ @ @ @ @ @ @ @ @ @ @ @ @ @ @ @ @ @ @ @ @ @ @ @ @ @ @   @ @ @ @ @]
[@       @           @   @               @   @                                                       @       @]
[@ @ @   @ @ @ @     @   @   @ @ @ @ @ @ @   @   @ @ @ @ @ @ @ @ @ @ @ @ @ @ @ @ @ @ @ @ @ @ @ @ @ @ @ @     @]
[@   @               @   @                   @                               @                               @]
[@   @ @ @ @ @ @     @   @ @     @ @ @ @ @ @ @ @ @ @ @ @ @ @ @ @ @ @ @ @     @   @ @ @ @ @ @ @ @ @ @ @ @ @ @ @]
[@                       @                                                   @                               @]
[@ @ @ @ @ @ @ @ @ @ @ @ @   @ @ @ @ @ @ @ @ @ @ @ @ @   @ @ @ @ @ @ @ @ @ @ @ @ @ @ @ @ @ @ @ @ @ @ @ @     @]
[@                           @                       @                                               @       @]
[@   @ @ @ @ @ @ @ @ @   @ @ @ @ @ @ @ @ @ @ @ @ @   @ @ @ @ @ @ @ @ @ @ @ @ @ @ @ @ @ @ @ @ @ @     @ @     @]
[@                   @   @                       @                                           @               @]
[@ @ @ @ @ @ @ @     @ @ @   @ @ @ @ @ @ @ @     @ @ @ @ @ @ @ @ @ @ @ @ @ @ @ @ @ @ @ @     @   @ @ @   @ @ @]
[@                           @                                                               @       @        ]
[@ @ @ @ @ @ @ @ @ @ @ @ @ @ @ @ @ @ @ @ @ @ @ @ @ @ @ @ @ @ @ @ @ @ @ @ @ @ @ @ @ @ @ @ @ @ @ @ @ @ @ @ @ @  ]
null
